111111111111111111111
100000101000101010001
101110101010101010111
100010001010000010101
101111101011111010101
100010101000001010001
111010111110111110111
100010000000100000121
111010111010111110101
100000100010000000001
111111111111111111111