1111111111111111111111111111111
1010000000100000001010000010001
1011101011101010101011101111101
1000101000001010100010100010101
1110101111111110101110111010101
1000101000000000100000001010001
1011111110111111111010111010101
1000001000101000100010000000101
1011101011101011111011111011101
1000100010000000000010000000121
1111111111111111111111111111111